2,2,2,2,2,2,2,1,1,1,1,2,2,2,2,2
2,2,2,2,2,2,2,1,2,2,1,1,2,2,2,2
2,2,2,2,2,2,2,1,2,2,2,1,1,2,2,2
2,2,2,2,2,2,2,1,2,4,4,2,1,1,2,2
2,2,2,2,2,1,1,1,4,2,2,4,2,1,1,2
2,2,1,1,1,1,2,2,2,2,4,2,2,2,1,2
1,1,1,2,2,1,2,1,1,1,1,1,2,2,1,2
1,2,2,2,2,1,2,1,3,3,3,3,4,2,1,2
1,2,1,2,2,2,4,2,3,3,3,3,1,2,1,2
1,2,2,4,2,1,2,1,3,5,3,3,1,2,1,2
1,1,1,2,2,1,1,1,1,2,1,1,1,2,1,2
2,2,1,1,1,1,2,6,4,2,2,1,1,4,1,1
2,2,2,2,2,1,1,1,2,4,2,2,2,2,2,1
2,2,2,2,2,2,2,1,2,2,1,1,2,2,2,1
2,2,2,2,2,2,2,1,1,1,1,1,1,1,1,1
