1,1,1,1,1
1,2,2,2,1
1,2,4,6,1
1,2,3,2,1
1,1,1,1,1