2,2,1,1,1,1,1,1,1,1,1,2,2
2,2,1,5,3,5,1,5,3,5,1,2,2
2,2,1,3,5,3,5,3,5,3,1,2,2
2,2,1,5,3,5,3,5,3,5,1,2,2
2,2,1,3,5,3,5,3,5,3,1,2,2
2,2,1,5,3,5,3,5,3,5,1,2,2
2,2,1,1,1,2,2,2,1,1,1,2,2
2,2,2,2,1,2,2,2,1,2,2,2,2
1,1,1,1,1,1,2,1,1,1,1,1,1
1,2,2,2,2,2,2,2,2,2,2,2,1
1,2,4,2,4,2,4,2,4,2,4,2,1
1,1,2,4,2,4,2,4,2,4,2,1,1
2,1,4,2,4,2,4,2,4,2,4,1,2
2,1,2,2,2,4,6,4,2,2,2,1,2
2,1,2,2,1,1,1,1,1,2,2,1,2
2,1,1,1,1,2,2,2,1,1,1,1,2
