1,1,1,1,1,1
1,6,2,2,2,1
1,2,2,2,2,1
1,2,2,4,2,1
1,2,2,2,3,1
1,1,1,1,1,1