1,1,1,1,1
1,6,2,2,1
1,2,4,2,1
1,3,2,2,1
1,1,1,1,1